name:Level_1 width:80 height:15 player_x:3 player_y:9 hitbox_b:3 hitbox_e:13 enemies:15 enemies_b:15 map_b:17

0:13.5 3:13.5 3:14 8:14 8:13.5 18:13.5 18:14 21:14 21:15 0:15
8:6 8:7.5 9:7.5 9:8 10:8 10:8.5 12:8.5 12:10 14:10 14:6 13:6 13:5.5 10:5.5 10:6
21:15 21:12 20:12 20:11.5 18:11.5 18:11 17:11 17:10 22:10 22:9.5 27:9.5 27:10 28:10 28:12 26:12 26:11.5 24:11.5 24:15
24:15 24:13.5 30:13.5 30:13 36:13 36:12.5 39:12.5 39:11 40:11 40:10 44:10 44:11.5 46:11.5 46:12 51:12 51:11.5 53:11.5 53:11 55:11 55:10 58:10 58:9.5 59:9.5 59:9 60:9 60:8.5 61:8.5 61:7.5 62:7.5 62:7 63:7 63:6 64:6 64:5.5 67:5.5 67:6 69:6 69:6.5 71:6.5 71:7 72:7 72:8 73:8 73:8.5 74:8.5 74:9.5 72:9.5 72:9 70:9 70:8.5 68:8.5 68:8 65:8 65:8.5 64:8.5 64:10 62:10 62:10.5 59:10.5 59:11 58:11 58:11.5 57:11.5 57:11 55:11 55:15
55:15 55:14 58:14 58:13.5 62:13.5 62:13 64:13 64:14 67:14 67:13.5 69:13.5 69:11.5 67:11.5 67:12 66:12 66:10.5 69:10.5 69:11 71:11 71:11.5 73:11.5 73:11 76:11 76:10.5 79:10.5 79:7 78:7 78:6.5 76:6.5 76:7 74:7 74:5 73:5 73:2.5 72:2.5 72:2 71:2 71:1 70:1 70:0 80:0 80:15
1:13.5 1:10.5 3:10.5 3:10 5:10 5:7.5 6:7.5 6:6 4:6 4:7 3:7 3:7.5 1:7.5 1:4.5 2:4.5 2:4 3:4 3:3.5 5:3.5 5:2.5 6:2.5 6:2 7:2 7:1 8:1 8:0.5 9:0.5 9:0 0:0 0:13.5
11:0 11:1 13:1 13:1.5 15:1.5 15:3 17:3 17:1.5 20:1.5 20:1 25:1 25:3 23:3 23:3.5 20:3.5 20:4 19:4 19:4.5 17:4.5 17:5 16:5 16:6.5 18:6.5 18:7 20:7 20:6 22:6 22:5.5 24:5.5 24:5 25:5 25:4 26:4 26:2 28:2 28:0.5 31:0.5 31:0
33:0 33:0.5 34:0.5 34:1 35:1 35:2 36:2 36:2.5 37:2.5 37:4 38:4 38:5 39:5 39:6 41:6 41:4 42:4 42:2.5 43:2.5 43:2 45:2 45:0
47:0 47:0.5 48:0.5 48:1 50:1 50:2 53:2 53:1.5 55:1.5 55:3 57:3 57:4 59:4 59:3 60:3 60:1.5 62:1.5 62:0.5 64:0.5 64:0
28:6.5 28:8 30:8 30:8.5 31:8.5 31:10 33:10 33:9 34:9 34:8.5 36:8.5 36:6 35:6 35:5.5 33:5.5 33:5 31:5 31:4.5 30:4.5 30:5 29:5 29:6.5
45:4 48:4 48:4.5 51:4.5 51:5 52:5 52:5.5 56:5.5 56:6.5 57:6.5 57:7 58:7 58:8 55:8 55:7.5 54:7.5 54:7 52:7 52:7.5 50:7.5 50:9 48:9 48:8.5 46:8.5 46:9 45:9 45:8.5 44:8.5 44:7.5 43:7.5 43:6 44:6 44:6.5 45:6.5 45:7 46:7 46:7.5 48:7.5 48:7 49:7 49:5.5 47:5.5 47:5 45:5

-27:-5:2 -28.5:3:0.5 -36.5:3.5 -18.5:5 -16:-1:1.5 -7.5:3.5 -12.5:-5 -2.5:-4 3.5:2.5:0 10:4 9:-3.5:2 25.5:3 36.5:-2 19:-5 26:-5.5

1 1 1 1 1 1 1 1 3 0 0 1 1 1 1 1 1 1 1 1 1 1 1 1 1 1 1 1 3 3 3 4 4 3 1 1 1 1 1 1 1 1 1 1 1 4 4 3 1 1 1 1 1 1 1 1 1 1 1 1 1 1 3 3 0 0 0 0 0 0 1 1 1 1 1 1 1 1 1 1
1 1 1 1 1 1 1 0 0 0 0 0 0 3 3 1 1 3 3 3 0 0 0 0 0 1 1 1 0 0 0 4 4 0 0 1 1 1 1 1 1 1 1 1 1 4 4 0 0 0 1 1 1 3 3 1 1 1 1 1 3 3 0 0 0 0 0 0 0 0 0 1 1 1 1 1 1 1 1 1
1 1 1 1 1 3 0 0 0 0 0 0 0 0 0 1 1 0 0 0 0 0 0 0 0 1 0 0 0 0 0 4 4 0 0 0 3 1 1 1 1 1 3 0 0 4 4 0 0 0 0 0 0 0 0 1 1 1 1 1 0 0 0 0 0 0 0 0 0 0 0 0 3 1 1 1 1 1 1 1
1 1 1 3 3 0 0 0 0 0 0 0 0 0 0 0 0 0 0 0 2 2 2 1 1 1 0 0 0 0 0 4 4 0 0 0 0 1 1 1 1 1 0 0 0 4 4 0 0 0 0 0 0 0 0 0 0 1 1 0 0 0 0 0 0 0 0 0 0 0 0 0 0 1 1 1 1 1 1 1
1 3 0 0 0 0 0 0 0 0 0 0 0 0 0 0 0 2 2 1 1 1 1 1 1 0 0 0 0 0 2 4 4 0 0 0 0 0 1 1 1 0 0 0 0 1 1 1 2 2 2 0 0 0 0 0 0 0 0 0 0 0 0 0 0 0 0 0 0 0 0 0 0 1 1 1 1 1 1 1
1 0 0 0 0 0 0 0 0 0 2 2 2 0 0 0 1 1 1 1 1 1 3 3 0 0 0 0 0 1 1 1 1 2 2 0 0 0 0 1 1 0 0 0 0 0 0 3 3 1 1 1 2 2 2 2 0 0 0 0 0 0 0 0 2 2 2 0 0 0 0 0 0 0 1 1 1 1 1 1
1 0 0 0 1 1 0 0 1 1 1 1 1 1 0 0 3 3 1 1 4 4 0 0 0 0 0 0 2 1 1 1 1 1 1 1 0 0 0 0 0 0 0 1 2 0 0 0 0 1 1 1 1 1 1 1 2 0 0 0 0 0 0 1 1 1 1 1 1 2 2 0 0 0 1 1 3 3 1 1
1 2 2 1 1 3 0 0 3 1 1 1 1 1 0 0 0 0 0 0 4 4 0 0 0 0 0 0 1 1 1 1 1 1 1 1 0 0 0 0 0 0 0 3 1 1 2 2 1 1 3 3 0 0 3 1 1 1 0 0 0 2 1 1 1 1 1 1 1 1 1 1 0 0 0 0 0 0 0 1
1 1 1 1 1 0 0 0 0 0 3 3 1 1 0 0 0 0 0 0 4 4 0 0 0 0 0 0 0 0 3 1 1 1 3 3 0 0 0 0 0 0 0 0 3 1 3 3 1 1 0 0 0 0 0 0 0 0 0 0 2 1 1 1 3 0 0 0 3 3 1 1 1 2 0 0 0 0 0 1
1 1 1 1 1 0 0 0 0 0 0 0 1 1 0 0 0 0 0 0 4 4 2 2 2 2 2 0 0 0 0 1 1 0 0 0 0 0 0 0 0 0 0 0 0 0 0 0 4 4 0 0 0 0 0 0 0 0 2 1 1 1 1 1 0 0 0 0 0 0 4 0 3 3 0 0 0 0 0 1
1 3 3 4 4 0 0 0 0 0 0 0 0 0 0 0 0 1 1 1 1 1 1 1 1 1 1 1 0 0 0 0 0 0 0 0 0 0 0 0 1 1 1 1 0 0 0 0 4 4 0 0 0 0 0 1 1 1 1 3 3 3 4 0 0 0 2 2 2 0 4 0 0 0 0 0 2 2 2 1
1 0 0 4 4 0 0 0 0 0 0 0 0 0 0 0 0 0 3 3 1 1 1 1 3 3 1 1 0 0 0 0 0 0 0 0 0 0 0 1 1 1 1 1 2 2 0 0 4 4 0 2 2 1 1 1 1 3 0 0 0 0 4 0 0 0 1 3 3 1 1 2 2 1 1 1 1 1 1 1
1 0 0 4 4 0 0 0 0 0 0 0 0 0 0 0 0 0 0 0 0 1 1 1 0 0 0 0 0 0 0 0 0 0 0 0 2 2 2 1 1 1 1 1 1 1 1 1 1 1 1 1 1 1 1 0 0 0 0 0 0 0 4 0 0 0 0 0 0 1 1 1 1 1 1 1 1 1 1 1
1 2 2 4 4 0 0 0 2 2 2 2 2 2 2 2 2 2 0 0 0 1 1 1 2 2 2 2 2 2 1 1 1 1 1 1 1 1 1 1 1 1 1 1 1 1 1 1 1 1 1 1 1 1 1 0 0 0 2 2 2 2 1 1 0 0 0 2 2 1 1 1 1 1 1 1 1 1 1 1
1 1 1 1 1 1 1 1 1 1 1 1 1 1 1 1 1 1 1 1 1 1 1 1 1 1 1 1 1 1 1 1 1 1 1 1 1 1 1 1 1 1 1 1 1 1 1 1 1 1 1 1 1 1 1 1 1 1 1 1 1 1 1 1 1 1 1 1 1 1 1 1 1 1 1 1 1 1 1 1